000000000000000
011111111111110
011111111111110
011111111111110
011111111111110
011111111111110
011111111111110
011111121111110
011111111111110
011111111111110
011111111111110
011111111111110
011111111111110
011111111111110
000000000000000
1
1
2
2