000000000000000
010111011110110
010101011111010
011101010121010
000011011111110
011110111110110
010001111101110
010111000111110
010111111111110
010111111111110
010100010000000
010111111111110
010000010000110
011111111111110
000000000000000
1
1
12
12