000000111111111
111131101101111
100000110110111
111131111011011
100100011101011
111131111101011
000100000001011
111111111111111
100000111011101
111111101101111
111100110110111
111011011011030
110111100110111
101111111113121
111111111110111
1
1
2
1