000011111111110
011010100001110
011110111111010
000010110011010
011111111101110
010011101101010
011011101101110
011111110111100
000111111100110
011110111111110
011010110110110
011010100110110
011011111110210
001111011111110
011111000111010
1
1
8
2