111111111111111
121111101111101
110111101111011
111011101110111
111101111101111
111110111011111
111111011111111
100011101110001
111111110111111
111110111011111
111101111101111
111011101110111
110111101111011
101111101111113
111111111111133
0
0
13
13