111101111110111
111101111111101
111101121110111
111101111110101
000300000010111
111111011111111
100111011111011
111111111011111
110111011010011
110111011111111
111011111111111
111110111011111
111111111011001
100110111110111
011110111111111
1
1
3
1