111110111111111
112110100100011
111110111111011
110111100101011
100011111111101
110110111101111
111110111101001
100010111111111
111110111110110
000000000000330
111110111101111
111110111101111
111113111131111
111110111101111
111110111101111
0
12
2
12