111101110111111
000101011100001
111101000011111
100011011110000
111110110001111
000000101111111
111111101101101
101000111101001
101010100111111
101001100001100
101011000111111
101011011111111
111111021100011
100001011111110
111111000111100
0
0
7
7