111111111111111
131111313111131
113111111111311
111311131113111
111110131011111
111101111101111
131111313111131
111331121133111
131111313111131
111101111101111
111110131011111
111311131113111
113111111111311
131111313111131
111111111111111
0
0
7
1